10, 10, 3
#legend
1=Dirt
2=TallGrass1
~
[1][1][1][1][1][1][1][1][1][1]
[1][1][1][1][1][1][1][1][1][1]
[1][1][1][1][1][1][1][1][1][1]
[1][1][1][1][1][1][1][1][1][1]
[1][1][1][1][1][1][1][1][1][1]
[1][1][1][1][1][1][1][1][1][1]
[1][1][1][1][1][1][1][1][1][1]
[1][1][1][1][1][1][1][1][1][1]
[1][1][1][1][1][1][1][1][1][1]
[1][1][1][1][1][1][1][1][1][1]
~
[ ][ ][2][ ][ ][ ][ ][ ][ ][ ]
[ ][ ][ ][ ][ ][ ][ ][ ][ ][ ]
[ ][ ][ ][ ][ ][2][ ][ ][ ][ ]
[ ][ ][2][ ][ ][ ][ ][ ][ ][ ]
[ ][ ][ ][ ][ ][ ][ ][ ][ ][ ]
[ ][ ][ ][ ][ ][ ][2][ ][ ][ ]
[ ][ ][ ][ ][ ][ ][ ][ ][ ][ ]
[ ][2][ ][ ][ ][ ][ ][ ][ ][ ]
[ ][ ][ ][ ][2][ ][ ][ ][ ][ ]
[ ][ ][ ][ ][ ][ ][ ][ ][ ][ ]